##########
#@#......#
#.#...*..#
#.#......#
#.#......#
#.#......#
#.B..#...#
#.#..#...#
##########