##########
#........#
#...*....#
#....B...#
#........#
#.@......#
#........#
#........#
##########